2

7 8
********
* * * **
* *    *
* * ** *
* * *  *
* * *  *
********
2 4
RRFLFF FFR
FF
RFFQ

7 8
********
* * * **
* *    *
* * ** *
* * *  *
* * *  *
********
2 4
RRFLFF FFR
FF
RFFQ